wwwwwwwwww
w....m...w
w.wwwwww.w
w.w.m..w.w
w...ww...w
w.w.ww.w.w
wpw.ww.w.w
w...ww...w
w.w....w.w
w.wwwwww.w
w.....m..w
wwwwwwwwww
