wwwwwwwwww
w........w
w.wwwwww.w
w.w....w.w
w........w
w.w....w.w
wpw....w.w
w........w
w.w....w.w
w.wwwwww.w
w........w
wwwwwwwwww
