wwwwwwwwww
w........w
w.wwwwww.w
w.w....w.w
w...ww...w
w.w.ww.w.w
wpw.ww.w.w
w...ww...w
w.w....w.w
w.wwwwww.w
w.....m..w
wwwwwwwwww
